1111111111111111111111111111111
1000000000000000000000000000001
1011111111100000111100000000001
100000000E100000100100000000001
1111111111100000111100000000001
1P00000000000000000000000000001
1111111111111111111111111111111