1111111111111111111111111111111
100000000000C00000000000C0000E1
10111111111000001111000000000E1
10000000001000C010010C000000001
1111111111100000111100000000001
1P0000000000C00000000000C000001
1111111111111111111111111111111