111111111111111111111111111111
1C00000000000000000000000000E1
111111111100000000000000000001
1C000000C100000000000000000001
100000000100000000000000000001
1C000000C100000000000000000001
100000000100000000000000000001
1P00000000000000000000000000C1
111111111111111111111111111111