11111111
10000001
1E000001
1C0C0C01
1P000001
11111111
