1111111111111111111111
10000000000000000000E1
1111111111000000000001
1000000001000000000001
1000000001000000000001
1000000001000000000001
1000000001000000000001
1P00000C000000C00000C1
1111111111111111111111
