11111111111111111
1E000000000C00NP1
10111111111111111
10000000000000001
11111111111111101
10100000000000101
11100000000000001
10000000000000001
10100000000001NN1
1000000000000NNN1
1010000000000NNN1
11111111111111111
