11111111111111111111
10000000000000000001
1CCCCCCCCCCCCCCCC101
1CCCCCCCCCCCCCCCC101
1CCCCCCCCCCCCCCCC101
1CCCCCCCCCCCCCCCC101
1CCCCCCCCCCCCCCCC101
1CCCCCCCCCCCCCCCC101
1CCCCCCCCCCCCCCCC101
1CCCCCCCCCCCCCCCC101
1CCCCCCCCCCCCCCCC101
1CCCCCCCCCCCCCCCC101
11111111111111111101
1EP00000000000000001
11111111111111111111
