1111111111111111111111111111111
100000000000C00000000000C000001
1011111111100000111100000000001
100000000E1000C010010C000000001
1111111111100000111100000000001
1P0000000000C00000000000C000001
1111111111111111111111111111111
